#############################################
#                                           #
#                                           #
#                                           #
#            ##                             #
#                                           #
##                                          #
#                                           #
#                   ###                     #
#           ###                             #
#                                           #
#      ####                                 #
#   #     @                                 #
#    ########################################
####                    #####################
#############################################
#############################################
#                       #####################
#                       #####################
#############################################