##################################################
#                                                #
#                                                #
#                                                #
#            ##                                  #
#                                                #
##                                               #
#                  |                             #
#                  |###                          #
#           ###    |                             #
#                  |                             #
#      ####        |                             #
#   #     @        |                             #
#    #############################################
####                    ##########################
##################################################
##################################################
#                       ##########################
#                       ##########################
##################################################