
##################################################
#                                                #
#                                                #
#                                                #
#            ##                                  #
#                                                #
##                                               #
#                  #  F                          #
#            F   # ####                          #
#           #####  #   #                         #
#                  #    #                        #
#      ####        #     #                       #
#   #     @  F     #      #            s         #
#    #############################################
####                    ##########################
##################################################
##################################################
#                       ##########################
#                       ##########################
##################################################