
##################################################
#                                                #
#                                                #
#                                                #
#            ##                                  #
#                                                #
##                                               #
#                  #                             #
#                # ####                          #
#           #####  #   #                         #
#                  #    #                        #
#      ####        #     #                       #
#   #     @  F     #      #S           s         #
#    #############################################
####                    ##########################
##################################################
##################################################
#                       ##########################
#                       ##########################
##################################################