#########################
#                       #
#                       #
#                       #
#            ##         #
#                       #
##                      #
#                       #
#                   ### #
#           ###         #
#                       #
#      ####             #
#   #     @             #
#    ####################
####                    #
#########################
#########################
#                       #
#                       #
#########################