
##################################################
#                                                #
#                                                #
#                                                #
#            ##                                  #
#                                                #
##                                               #
#                  #                             #
#                # ####                          #
#           #####  #   #                         #
#       S          #    #                        #
#      ####        #     #                       #
#   #     @  F     #      #S           s         #
#    #############################################
####                    ##########################
##########     ###################################
##########    ####################################
#           #           ##########################
#        #     #        ##########################
##################################################