##########
#....@...#
#..###..#.
.#......##
#...#.#..#
#..#...#.#
#...###..#
##.......#
###.....##
##########