##################################################
#                                                #
#                                                #
#                                                #
#            ##                                  #
#                                                #
##                                               #
#                  |  F                          #
#            F     |###                          #
#           ###    |                             #
#                  |                             #
#      ####        |                             #
#   #     @  F     |                             #
#    #############################################
####                    ##########################
##################################################
##################################################
#                       ##########################
#                       ##########################
##################################################