#############################
#...........................#
##..........................#
#...........................#
######..........##....#######
#.....##..#.................#
#.@..........#.##.###.#######
#############################